%%%%%%%%%%%%%%%%%%%%%%%%%%%%%%%%%%%%%
%                                   %
% %%  %% %% %% %%%%  %%   % %% % %  %
%   %               %   %         % %
% %%% %% % %% % % %   %   %%%%% %%  %
%     % % % % %     %   %     % %   %
%  %% %  % %%   %% %% % %%%% % % %% %
%   %   %     % %   %   %         % %
% % % % %% %%   % %   % % % %%% %   %
% %           %     %     %   %   % %
% %%% %%% %% % % %%% % %%  % %%% %  %
%     %   %       %   % % %   %   % %
% %%% %% % % %%%% %%%%%%    % % % % %
% %     % % %     %   % % % %       %
%  %% %%    %% % % % %% %  % %% %%  %
%       % % %             %   %     %
% %%%% %     % % %% % % %   %  % %% %
%.% % % % % % % % %   %   % % %     %
%  % %  %% %%% %  %% %% %   %% %% % %
% % % %   %   % %         % %   % % %
%      %%  % %    % % % % %  % %% % %
% % % %   %   % %           % %     %
% %% %% %  % %%%%% %%%% % %%%   %%% %
%     %   %           % % %   %     %
%  % % %%%  %% % %% % %%%% % %  % % %
% %     % % %           %     % % % %
% %% %%% %  %%% % %% % %% % %% %%   %
%       % % % % %   %     %       % %
% % %%% % %     % % %% % %  % %% %% %
% %         % % % % % %   %   % %   %
%  %%% % % %%     % %%% %%  % % %%  %
%   %   % % % % %         %   %   % %
% %  % %   %%    %% % %%%% %%  %%%  %
% % %   % %   % %           % %     %
% %% % %  % %   % %% % % %% % % % % %
%       %     %   % % % %       % %P%
%%%%%%%%%%%%%%%%%%%%%%%%%%%%%%%%%%%%%
