%%%%%%%%%%%%%%%
%.      %     %
% %%%% %%% %  %
% %   % %   % %
%   %% %% %%  %
% %       % % %
%% % %% %%%%  %
% %         % %
%   %%% % %%% %
% %   % %     %
% %%%     %% %%
%   % % % %   %
%%%%%  %%   % %
%     %   % %P%
%%%%%%%%%%%%%%%
