%%%%%%%%%%%%%%%%%%%%%%%%%%%%%%%%%%%%%%%%%%%%%%%%%
%      P      .%   ..       .%  .% ..  %.%  .%. %
% %%%%%%% %%%%%% %  % % %%         %%%%  %  %%% %
%   .%.%    % .% %  % % .%   % . % .    .%  %   %
%.   %    .      %.   % %%%% %   %   %%%%%  %.  %
%%%%%%%%%%%%%%  %%%%%%%          .%    %  %     %
%.               .   .% %%%  %%%%%%    %  %.% % %
%%%%%%%%%%%%%%%%%%%%%%% %   .%  . %% % %  . %.% %
% .  %..%.     % .%  .. % %%%%.      %.  %%%%.% %
%.      %%  %. %  %..   %   .     %       .%.   %
% % %%% .  %.%    %%%%% %%%%%% %  % % %%%%%%%%% %
% . %  . %   .%   .         .% .  %.    .%.     %
%%%%%%%%%%%%%%%%%%%%%%%%%%%%%%%%%%%%%%%%%%%%%%%%%
