%%%%%%%%%%%%%%%%%%%%%%%%%%%%%%%
%...%........%%%%%............%
%%%.%...%%%.........%.%...%.%%%
%...%%%.%.%%%%.%.%%%%%%.%%%...%
%.%.....%..P...%......%.....%.%
%.%%%.%%%.%%%%%%%%%.%%%.%.%%%%%
%.....%.........%...%...%.....%
%%%%%%%%%%%%%%%%%%%%%%%%%%%%%%%
