%%%%%%%%%%%%%%%%%%%%%%%%%%%%%%%%%%%%%
%                                   %
%                                   %
%                                   %
%          %%%%%%%%%%%%%%%%%%%%%    %
%          %                   %    %
%          %      %%%%%%%%%%   %    %
%          %      %        %   %    %
%          %      %        %   %    %
%          %      %        %   %    %
%          %      %       P%   %    %
%          %      %    %%%%%   %    %
%          %      %            %    %
%          %      %            %    %
%                 %            %    %
%                 %%%%%%%%%%%%%%    %
%                                   %
%                                   %
%     .                             %
%%%%%%%%%%%%%%%%%%%%%%%%%%%%%%%%%%%%%