%%%%%%%%%%%%%%%%%%%%%%%%%%%%%%%%
%                             P%
% %  %%%%%%%%%%%%%%%%%%%%%%%%% %
% %                %       %   %
% %    %%%%%%%%%%% % %%%%% % %%%
% %%%% %           %   %   %   %
%   %    %%%%%%%%%%%%% % %%%%% %
%               %      %       %
% %%%%%%%%%%%%%%%% %%%%%%%%%%%%%
%                             .%
%%%%%%%%%%%%%%%%%%%%%%%%%%%%%%%%
