%%%%%%%%%%%%%%%%%%%%%%%%%%%%%%
%      P      .%   ..        %
% %%%%%%% %%%%%% %  % % %%   %
%   .%..      .% %  % % .%...%
%.        .      %.   % .%%% %
%%%%%%%%%%%%%%  %%%%%%%     .%
%..              .   .% %%%  %
%%%%%%%%%%%%%%%%%%%%%%% %   .%
%    ...%.        %     % %%%%
%.      %%  %.   .%..   %   .%
%.% %%%    %.%    %%%%% %%%%%%
%            .%        .    .%
%%%%%%%%%%%%%%%%%%%%%%%%%%%%%%
