%%%%%%%%%%%%%%%%%%%%%%%
%      P      .%   .. %
% %%%%%%% %%%%%% %  % %
%   .%..      .% %  % %
%.        .      %.   %
%%%%%%%%%%%%%%  %%%%%%%
%..              .   .%
%%%%%%%%%%%%%%%%%%%%%%%
