%%%%%%%%%%%%%%%%%%%%%%%%%%%%%%%%%%%%%%%%%%%%%%%%%%%%%%%%%%%%%%%%%%%%%%%%%%%%%%
%............%%.............%.....................%............%%............%
%.%%%%.%%%%%.%%.%%%%.......%...............%.%%%%.%.%%%%.%%%%%.%%.%%%%%.%%%%.%
%.........................%.......................%..........................%
%.%%%%.%%.%%%%%%%%........%...............%%.%%%%.%.%%%%.%%.%%%%%%%%.%%.%%%%.%
%......%%....%%....%%......%..........%..................%%....%%....%%......%
%%%%%%.%%%%% %% %%%.......%...............%%.%%%%%%%%%%%.%%%%% %% %%%%%.%%%%%%
%......   %.    .%   ........%....................%......   %.    .%   ......%
%%%%%%.%% %%%%%%.......%...............%% %%.%%%%%%%%%%%.%% %%%%%%%% %%.%%%%%%
%............%%.............%.....................%............%%............%
%.%%%%.%%%%%.......%................%%.%%%%%.%%%%.%.%%%%.%%%%%.%%.%%%%%.%%%%.%
%....%...........%.................. P.......%....%....%.......  .......%....%
%%%%.%.%%.%%%%%%.......%...............%%.%%.%.%%%%%%%.%.%%.%%%%%%%%.%%.%.%%%%
%......%%....%%........%..................%%......%......%%....%%....%%......%
%.%%%%%%%%%%........%...............%%.%%%%%%%%%%.%.%%%%%%%%%%.%%.%%%%%%%%%%.%
%......................%..........................%..........................%
%............%.......%...............%............%............%%............%
%.%%%%.%%%%%.%.......%...............%.%%%%%.%%%%.%.%%%%.%%%%%.%%.%%%%%.%%%%.%
%......................%..........................%..........................%
%.%%%%.%%.%%%%%%%%.%%.%%.......%...............%%.%.%%%%.%%.%%%%%%%%.%%.%%%%.%
%......%%....%%.......%...................%%......%......%%....%%....%%......%
%%%%%%.%%%%% %% %%%%%.%%%%%%%%.......%...............%%%.%%%%% %% %%%%%.%%%%%%
%......   %.    .%   ......%.........%...................   %.    .%   ......%
%%%%%%.%% %%%%%%%% %%........%...............%%%%%%%%%%%.%% %%%%%%%% %%.%%%%%%
%............%%............%......................%............%%............%
%.%%%%.%%%%%.%%.%%%%.......%...............%.%%%%.%.%%%%.%%%%%.%%.%%%%%.%%%%.%
%....%.......  .........%....................%.... %....%.......  .......%...% 
%%%%.%.%%.%%%%%%%%.......%................%%.%.%%%%%%%.%.%%.%%%%%%%%.%%.%.%%%%
%......%%....%%....%%........%....................%......%%....%%....%%......%
%.%%%%%%%%%%.%%.%.......%...............%%%%%%%%%.%.%%%%%%%%%%.%%.%%%%%%%%%%.%
%......................%....................................................%%
%%%%%%%%%%%%%%%%%%%%%%%%%%%%%%%%%%%%%%%%%%%%%%%%%%%%%%%%%%%%%%%%%%%%%%%%%%%%%%
